############################# ###########
#   #   #       #     #     #     #     #
# # # ### ##### ### ### ### ##### # #####
# # # #   #   #       # #   #     #     #
# # # # ### # ####### # ##### ### ### # #
# # #   #   #   # #   # #     # # #   # #
### # ### # ### # # ### # ##### # ##### #
#   #     #   #   # #   # #   # # #   # #
# ########### ##### ### # ### # # # # # #
#   #       #     # #   # #     # # # # #
# # ##### ####### # # ### # ##### # # # #
  #       #   # # #     #       #   # # #
# ########### # # ##### ####### ####### #
# #   #       #   #   #   #   #     #   #
# # # ### ####### # ##### # ##### # # ###
# # #   #     #         #       # # #   #
# ##### ### ### ####### ####### # ##### #
# #       #   #     #   #     # #   # # #
# # ##### ### ##### # ### ### # # # # # #
#       #           #     #   #   #     #
#########################################